s, , , , ,
 ,e, , , ,
 , , , , ,
 , , , , ,
 , , , , ,
