s, , , , ,
m,e,&,O, ,
 , , , , ,
 ,&, , , ,
 , , , , ,
